1111111111111111111111111111111111111
10P0011C11111111111110000001111111111
1C00C000C111111100100CCCCC00E11111111
1000111000000001010011111100111111111
1111000000111111110011111100111111111
111111100001111111CC00011001111111111
1111111000011111100000000111111111111
1111110000000C11111100CC1111111111111
1111001111100000000000C00000000111111
1100000000111100C00001111111111111111
1111111111111111111111111111111111111
